1,1,1,1,1,1,1,1,1,1,1,1,1,1,1,1
1,0,0,0,0,0,0,3,4,4,2,0,0,0,0,1
1,0,0,0,0,0,0,3,0,0,2,0,0,0,0,1
1,0,0,0,0,0,0,3,4,4,4,2,0,0,0,1
1,0,0,0,0,0,0,3,0,0,0,2,0,0,0,1
11,0,0,0,0,0,0,7,4,4,4,6,0,0,0,1
11,0,0,0,0,0,0,0,0,0,0,0,0,0,0,1
11,0,0,0,0,0,0,0,0,0,0,0,0,0,0,1
1,1,1,1,1,1,1,1,1,1,1,1,1,1,1,1
