1,1,1,1,1,1,1,1,1,1,1,1,1,1,1,23,23,23,23,23,23,1,1,1,1,1
0,0,0,0,0,0,0,0,0,0,0,0,0,0,0,24,24,24,24,24,23,23,23,1,1,1
0,0,0,0,0,0,0,0,0,0,0,0,0,0,0,24,24,23,24,24,24,24,23,1,1,1
0,0,0,0,0,0,0,0,0,0,0,0,0,0,3,23,23,23,23,23,23,23,23,1,1,1
0,0,0,0,0,0,0,0,0,0,0,0,0,0,0,4,1,1,0,1,1,1,1,1,0,0
0,0,0,0,0,0,0,0,0,0,0,0,0,0,0,0,0,0,0,0,0,0,0,0,0,0
0,0,0,0,0,0,20,0,0,0,0,0,0,0,0,0,0,0,0,0,0,0,0,0,0,0
0,0,0,0,0,0,0,0,0,0,0,0,0,0,0,0,0,0,0,0,0,0,0,0,0,0
1,1,1,1,1,1,1,1,1,1,1,1,1,1,1,0,0,1,1,1,1,1,1,1,1,1
