1,1,1,1,1,1,1,1,1
1,4,4,2,0,0,0,0,1
1,3,4,6,0,0,0,0,1
1,7,4,4,0,0,0,0,1
0,0,0,0,0,0,0,0,0
0,0,0,0,0,0,0,0,0
0,0,0,0,0,0,0,0,0
0,0,5,0,0,0,0,0,0
1,0,0,1,1,1,1,1,1
