0,0,0,0,0,0,0,0,0,0,0,50,50,50,50,50,50,0,0,0,0,0,0,0
0,50,0,0,0,50,0,50,0,50,0,50,50,50,50,50,50,0,0,50,50,50,0,0
0,50,0,0,0,50,0,50,0,50,0,50,50,50,50,50,50,0,0,50,50,50,0,0
0,50,0,0,0,50,0,50,0,50,0,50,50,50,50,50,50,0,0,0,0,0,0,0
0,50,0,0,0,50,0,50,0,50,0,50,50,50,50,50,50,0,0,50,50,50,0,0
0,50,0,0,0,50,0,50,0,50,0,50,50,50,50,50,50,0,0,50,50,50,0,0
0,50,0,0,0,50,0,50,0,50,0,50,50,50,50,50,50,0,0,50,50,50,0,0
0,50,0,0,0,50,0,50,0,50,0,50,50,50,50,50,50,0,0,50,50,50,0,0
0,50,0,0,0,50,0,50,0,50,0,50,50,50,50,50,50,0,0,50,50,50,0,0
0,50,0,0,0,50,0,50,-1,50,0,50,50,50,50,50,50,0,0,50,50,50,0,0
0,50,0,0,0,50,0,50,-1,50,0,50,50,50,50,50,50,0,0,50,50,50,0,0
0,50,0,0,0,50,0,50,-1,50,0,50,50,50,50,50,50,0,0,50,50,50,0,0
